Level 1
23
#########
##### H##
##  M  ##
## M M###
#  ######
# B  B ##
# B B  D#
#########
